  XXX   XXX
X  XX X  XX 
X   X X  XX 
XXX   X  XX
XXXXXXXXDXX